#####################################
#                                   #
#   #########                       #
#   #       #                       #
#   #       #                       #
#   #                               #
#   #       #                       #
#   # ## ####                       #
#   #                               #
#   #                               #
#                                   #
#####################################